22 01 22 01 01 04 01 22 01 01 01 22 01 01 01 01 04 01 01 01 01 01 22 01 22 01 22 01 01 04 01 22 01 01 01 22 01 01 01 01 04 01 01 01 01 01 22 01
01 01 02 01 01 04 01 01 01 01 01 02 01 01 01 01 04 01 01 02 01 01 01 01 01 01 02 01 01 04 01 01 01 01 01 02 01 01 01 01 04 01 01 02 01 01 01 01
01 01 22 01 01 04 01 01 22 01 01 01 22 01 22 01 04 01 22 01 01 01 01 01 01 01 22 01 01 04 01 01 22 01 01 01 22 01 22 01 04 01 22 01 01 01 01 01
06 06 06 06 06 10 01 01 01 01 23 01 09 06 06 06 05 06 06 06 06 06 06 06 06 06 06 06 06 10 01 01 01 01 23 01 09 06 06 06 05 06 06 06 06 06 06 06
01 01 01 01 02 04 01 01 01 02 01 01 04 01 01 01 04 01 01 01 01 01 01 01 01 01 01 01 02 04 01 01 01 02 01 01 04 01 01 01 04 01 01 01 01 01 01 01
01 22 01 01 01 04 01 23 01 22 01 01 04 01 01 01 04 01 23 01 01 01 01 22 01 22 01 01 01 04 01 23 01 22 01 01 04 01 01 01 04 01 23 01 01 01 01 22
01 01 01 01 01 04 01 01 22 01 01 01 04 01 01 01 03 06 06 06 07 01 01 01 01 01 01 01 01 04 01 01 22 01 01 01 04 01 01 01 03 06 06 06 07 01 01 01
01 02 01 01 01 03 06 06 06 06 06 06 08 06 07 01 02 01 01 01 04 01 01 02 01 02 01 01 01 03 06 06 06 06 06 06 08 06 07 01 02 01 01 01 04 01 01 02
01 01 22 01 01 01 01 01 01 01 22 01 01 01 04 01 01 01 22 01 04 01 01 01 01 01 22 01 01 01 01 01 01 01 22 01 01 01 04 01 01 01 22 01 04 01 01 01
01 01 01 01 01 23 02 01 01 01 01 01 01 01 04 01 23 02 01 01 04 01 01 01 01 01 01 01 01 23 02 01 01 01 01 01 01 01 04 01 23 02 01 01 04 01 01 01
01 01 01 22 01 01 01 01 01 01 01 22 01 01 04 01 01 22 01 01 04 01 01 01 01 01 01 22 01 01 01 01 01 01 01 22 01 01 04 01 01 22 01 01 04 01 01 01
01 01 01 01 01 01 01 01 01 01 01 01 01 01 04 01 09 06 06 06 15 01 01 01 01 01 01 01 01 01 01 01 01 01 01 01 01 01 04 01 09 06 06 06 15 01 01 01
01 01 01 01 01 09 06 06 06 06 06 06 06 06 15 01 04 01 01 01 01 01 01 01 01 01 01 01 01 09 06 06 06 06 06 06 06 06 15 01 04 01 01 01 01 01 01 01
01 01 01 01 01 04 01 01 01 01 01 01 01 01 01 01 04 01 01 01 01 01 01 01 01 01 01 01 01 04 01 01 01 01 01 01 01 01 01 01 04 01 01 01 01 01 01 01
01 01 01 01 01 04 01 01 01 01 01 01 01 01 01 01 04 01 01 01 01 01 01 01 01 01 01 01 01 04 01 01 01 01 01 01 01 01 01 01 04 01 01 01 01 01 01 01
22 01 22 01 01 04 01 22 01 01 01 22 01 01 01 01 04 01 01 01 01 01 22 01 22 01 22 01 01 04 01 22 01 01 01 22 01 01 01 01 04 01 01 01 01 01 22 01
01 01 02 01 01 04 01 01 01 01 01 02 01 01 01 01 04 01 01 02 01 01 01 01 01 01 02 01 01 04 01 01 01 01 01 02 01 01 01 01 04 01 01 02 01 01 01 01
01 01 22 01 01 04 01 01 22 01 01 01 22 01 22 01 04 01 22 01 01 01 01 01 01 01 22 01 01 04 01 01 22 01 01 01 22 01 22 01 04 01 22 01 01 01 01 01
06 06 06 06 06 10 01 01 01 01 23 01 09 06 06 06 05 06 06 06 06 06 06 06 06 06 06 06 06 10 01 01 01 01 23 01 09 06 06 06 05 06 06 06 06 06 06 06
01 01 01 01 02 04 01 01 01 02 01 01 04 01 01 01 04 01 01 01 01 01 01 01 01 01 01 01 02 04 01 01 01 02 01 01 04 01 01 01 04 01 01 01 01 01 01 01
01 22 01 01 01 04 01 23 01 22 01 01 04 01 01 01 04 01 23 01 01 01 01 22 01 22 01 01 01 04 01 23 01 22 01 01 04 01 01 01 04 01 23 01 01 01 01 22
01 01 01 01 01 04 01 01 22 01 01 01 04 01 01 01 03 06 06 06 07 01 01 01 01 01 01 01 01 04 01 01 22 01 01 01 04 01 01 01 03 06 06 06 07 01 01 01
01 02 01 01 01 03 06 06 06 06 06 06 08 06 07 01 02 01 01 01 04 01 01 02 01 02 01 01 01 03 06 06 06 06 06 06 08 06 07 01 02 01 01 01 04 01 01 02
01 01 22 01 01 01 01 01 01 01 22 01 01 01 04 01 01 01 22 01 04 01 01 01 01 01 22 01 01 01 01 01 01 01 22 01 01 01 04 01 01 01 22 01 04 01 01 01
01 01 01 01 01 23 02 01 01 01 01 01 01 01 04 01 23 02 01 01 04 01 01 01 01 01 01 01 01 23 02 01 01 01 01 01 01 01 04 01 23 02 01 01 04 01 01 01
01 01 01 22 01 01 01 01 01 01 01 22 01 01 04 01 01 22 01 01 04 01 01 01 01 01 01 22 01 01 01 01 01 01 01 22 01 01 04 01 01 22 01 01 04 01 01 01
01 01 01 01 01 01 01 01 01 01 01 01 01 01 04 01 09 06 06 06 15 01 01 01 01 01 01 01 01 01 01 01 01 01 01 01 01 01 04 01 09 06 06 06 15 01 01 01
01 01 01 01 01 09 06 06 06 06 06 06 06 06 15 01 04 01 01 01 01 01 01 01 01 01 01 01 01 09 06 06 06 06 06 06 06 06 15 01 04 01 01 01 01 01 01 01
01 01 01 01 01 04 01 01 01 01 01 01 01 01 01 01 04 01 01 01 01 01 01 01 01 01 01 01 01 04 01 01 01 01 01 01 01 01 01 01 04 01 01 01 01 01 01 01
01 01 01 01 01 04 01 01 01 01 01 01 01 01 01 01 04 01 01 01 01 01 01 01 01 01 01 01 01 04 01 01 01 01 01 01 01 01 01 01 04 01 01 01 01 01 01 01